                                                                                                                                                                                                                                                                                                                                                                                                                                
                                                                                                                                                                                                                                                                                                                                                                                                                                
                                                                                                                                                                                                                                                                                                                                                                                                                                
                                                                                                                                                                                                                                                                                                                                                                                                                                
                                                                                                                                                                                                                                                                                                                                                                                                                                
                                                                                                                                                                                                                                                                                                                                                                                                                                
                                                                                                                                                                                                                                                                                                                                                                                                                                
                                                                                                                                                                                                                                                                                                                                                                                                                                
                                                                                                                                                                                                                                                                                                                                                                                                                                
                                                                                                                                    ##########                                                                                                                                                                                                                                                                                  
                                                                                                                                    ##########                                                                                                                                                                                                                                                                                  
                        ##########                                                                                                                                                                      ##########                                                                                                                                                                                                              
                        ##########                                                                                                                                                                      ##########                                                                                                                                                                                                              
                                                                                                                                                                                                                                                                                                                        ####                                                                                                    
                                                                                                                                                                                                                                                                                                                        ####                                                                                                    
                                                                                                                                                                                                                                                                                                                        ####                      ######################                                                        
                                                                                                                                                                                                                                                        ##########                                                      ####                      ######################                                                        
                                                                                                                                                                                                                                                        ##########                                                      ####                                                                                                    
                                                                                    ####                                                                                                                                                                                                                                ####                                                                                                    
                                                                                    ####                                                                                                                                                                                                                                ####                                                                                                    
                                                                                    ####                                                                        ##                                                                                                                                                      ####                                                                                                    
                                                                                    ####                                                                        ##                                                                                                                                                      ####                                                                                                    
##################################################################      ######################################################################################################################################################################################################        ##########################################################################################################################################
##################################################################      ######################################################################################################################################################################################################        ##########################################################################################################################################