                                                                                                                                                                                                                                                                                                                                                                                                                                
                                                                                                                                                                                                                                                                                                                                                                                                                                
                                                                                                                                                                                                                                                                                                                                                                                                                                
                                                                                                                ########                                                                                                                                                                                                                                                                                                        
                                                                                                                ########                                                                                                                                                                                                                                                                                                        
                                                  ##########                                                                                                                    ##########                                                                                                                                                                                                                                      
                                                  ##########                                                                                                                    ##########                                                                                                                                                                                                                                      
                                                                                                                                                                                                                                                                                                                                                                                                                                
                                                                                                                                                                                                                                                                                                                                                                                                                                
                                                                                                                                    ##########                                                                                                                                                                          ####                                                                                                    
                                                                                                                                    ##########                                                                                                                                                                          ####                                                                                                    
                             ##########                                                                                                                                                                 ##########                                                              ######################                  ####                                                                                                    
                             ##########                                                                                                                                                                 ##########                                                              ######################                  ####                                                                                                    
                                                                                                                                                                                                                                                                                                                        ####                                                                                                    
                                                                                                                                                                                                                                                                                                                        ####                                                                                                    
                                                                                                                                                                                                                                                                                                                        ####                      ######################                                                        
                                                                                                                                                                                                                                                        ##########                                                      ####                      ######################                                                        
                                                                                                                                                                                                                                                        ##########                                                      ####                                                                                                    
                                                                ##                  ####                                                                                                                                                                                                                                ####                                                                                                    
                                                                ##                  ####                                                                                                                                                                                                                                ####                                                                                                    
                                                                ##                  ####                                                                        ##                                                                                                                                                      ####                                                                                                    
                                                                ##                  ####                                                                        ##                                                                                                                                                      ####                                                                                                    
##################################################################      ######################################################################################################################################################################################################        ##########################################################################################################################################
##################################################################      ######################################################################################################################################################################################################        ##########################################################################################################################################